Avignon=Avinyó
EEUU=EUA
USA=EUA
Jijona=Xixona
Linneo=Linneu|Linné
Mediterrà=Mediterrani|Mediterrània
Mefistòfeles|Mefistófeles=Mefistòfil
Melchor|Melxor=Melcior
Ninyo=Infant Jesús|Jesuset|Nen Jesús
Odon=Ot|Otó
Oporto=Porto
Orihuela=Oriola
abort=avortament|aborció|gastament
aborts=avortaments|aborcions|gastaments
aconteixements|aconteiximents=esdeveniments
aconteixement|aconteiximent=esdeveniment
acreedor=creditor
acreedora=creditora
acreedores=creditores
acreedors=creditors
admón=adm
aixina|aixins|aixís=així
alemans=alemanys
alemàn|aleman|alemà=alemany
alimentici=alimentari
alimenticis=alimentaris
alimentícia=alimentària
alimentícies=alimentàries
antes=abans
assuntos|asuntos=assumptes
assunto|asunto=assumpte
aveiam=vejam|vegem
avenida=avinguda
avenides=avingudes
avenència=avinença
averiguacions=indagacions|investigacions|escatiments|esbrinaments
averiguació=indagació|investigació|escatiment|esbrinament
averiguar=esbrinar|escatir|investigar|indagar|inquirir
avestruç=estruç
avestruços=estruços
avispada=eixerida|espavilada|avisada|desperta
avispades=eixerides|espavilades|avisades|despertes
avispat=eixerit|espavilat|avisat|despert
avispats=eixerits|espavilats|avisats|desperts
bonus=gratificació|prima|bonificació|gratificacions|primes|bonificacions
botellon=festa alcohòlica
botellones=festes alcohòliques
botellons=festes alcohòliques
botellón=festa alcohòlica
brillantesa=brillantor
bueno=bé|bo
cansanci=cansament
cansancis=cansaments
carajillo=cigaló|rebentat|cafè amb gotes
carajillos=cigalons|rebentats|cafès amb gotes
carent=mancat|mancada|freturós|freturosa
carents=mancats|mancades|freturosos|freturoses
carinyo=estimat|estimada|rei|reina|amor|amor meu|vida|afecte|estima|estimació|afecció
cercanies=voltants|encontorns|rodalia
cobaia=conill porquí|conill d'Índies|conillet d'Índies|conill de rata|cobai
cobaies=conills porquins|conills d'Índies|conillets d'Índies|conills de rata|cobais
cocktail=còctel
cocktails=còctels
codornisses|codornius=guatlles|guatles
codornís|codorniu=guatlla|guatla
debacle=desbandada|desfeta|ruïna|desastre|derrota
debacles=desbandades|desfetes|ruïnes|desastres|derrotes
debe=deure|dèbit
deixacions=desistiments
deixació=desistiment
derroches|derrotxes=dilapidacions|malbarataments|balafiaments
derroche|derrotxe=dilapidació|malbaratament|balafiament
derrotxadora|derrochadora=malgastadora|malbaratadora|dilapidadora|balafiadora
derrotxadores|derrochadores=malgastadores|malbaratadores|dilapidadores|balafiadores
derrotxadors|derrochadors=malgastadors|malbaratadors|dilapidadors|balafiadors
derrotxador|derrochador=malgastador|malbaratador|dilapidador|balafiador
desagravi=desgreuge|desgreujament|reparació|compensació|recompensa|retorn
desagravis=desgreuges|desgreujaments|reparacions|compensacions|recompenses|retorns
desahuci=desnonament
desahuciar=desnonar
desahucis=desnonaments
desprovist=desproveït
desprovista=desproveïda
desprovistes=desproveïdes
desprovistos=desproveïts
desprovists=desproveïts
después=després
disparatada=esbojarrada|desenfrenada|absurda|que no va enlloc
disparatades=esbojarrades|desenfrenades|absurdes|que no va enlloc
disparatat=esbojarrat|desenfrenat|absurd|que no va enlloc
disparatats=esbojarrats|desenfrenats|absurds|que no va enlloc
ditxosa=maleïda|dels pebrots|sortosa|feliç|afortunada
ditxoses=maleïdes|dels pebrots|sortoses|felices|afortunades
ditxosos=maleïts|dels pebrots|sortosos|feliços|afortunats
ditxós=maleït|dels pebrots|sortós|feliç|afortunat
dolència=mal|malaltia|molèstia|xacra
dolències=mals|malalties|molèsties|xacres
dominguera=pixapins
domingueres=pixapins
dominguero=pixapins
domingueros=pixapins
doña=senyora
dña=sra
enfermetat=malaltia
enfermetats=malalties
enradere|enradera=endarrere
ensaig=assaig
ensaladera=enciamera
ensaladeres=enciameres
ensaladilla=ensalada|amanida
ensaladilles=ensalades|amanides
ensanxe=eixample|eixampla
ensanxes=eixamples
ensenada=ansa|cala|ancó|rada|badia
ensenades=anses|cales|ancons|rades|badies
ensimismada=abstreta|pensarosa|concentrada|capficada|entotsolada
ensimismades=abstretes|pensaroses|concentrades|capficades|entotsolades
ensimismat=abstret|pensarós|concentrat|capficat|entotsolat
ensimismats=abstrets|pensarosos|concentrats|capficats|entotsolats
entente=entesa
ententes=enteses
enterada=assabentada
enterades=assabentades
enterado=conformitat
enterat=assabentat
enterats=assabentats
entonces|entonses=aleshores|llavors
facilón|facilon|facilona|facilones|facilons=massa fàcil|d'allò més fàcil|molt fàcil|massa fàcils|molt fàcils
financiacions=finançaments
financiació=finançament
finançacions=finançaments
finançació=finançament
finiquito=liquidació|quitança
finiquitos=liquidacions|quitances
frambuesa=gerdó|gerd
frambueses=gerdons|gerds
fronterissa=fronterera|frontera
fronterisses=frontereres|fronteres
fronterissos=fronterers|fronters
fronterís=fronterer|fronter
galardons=guardons|recompenses
galardó=guardó|recompensa
ganader=ramader
ganaderia=ramaderia
ganaders=ramaders
ganancial=de guanys|beneficiari|beneficiària
ganancials=de guanys|beneficiaris|beneficiàries
ganància=guany
ganàncies=guanys
garaig=garatge
garaix=garatge
garaixos=garatges
garantitzar=garantir
garatx=garatge
garbo=airositat|aire|gràcia
garbosa=airosa|graciosa|gentil|ampla
garboses=airoses|gracioses|gentils|amples
garbosos=airosos|graciosos|gentils|amples
garbós=airós|graciós|gentil|ample
garganta=gola|gorja|gargamella
gargantes=goles|gorges|gargamelles
gelos=gelosia
gilipollada=imbecil·litat|estupidesa
gilipollades=imbecil·litats|estupideses
gilipollas=carallot|torracollons|caracollons|capsigrany|pallús|tros d'ase|soca|imbècil|estúpid|fava
gilipolles=carallot|torracollons|caracollons|capsigrany|pallús|tros d'ase|soca|imbècil|estúpid|fava
gimnàsia=gimnàstica
habilidosa=traçuda|manyosa
habilidoses=traçudes|manyoses
habilidosos=traçuts|manyosos
habilidós=traçut|manyós
halago=afalac
halagos=afalacs
hasta=fins|fins a
hermós=formós|bell|bonic|maco
hermosa=formosa|bella|bonica|maca
hermosos=formosos|bells|bonics|macos
hermoses=formoses|belles|boniques|maques
hermosura=formosor|bellesa|boniquesa|bellor
hermosures=formosors|belleses|boniqueses|bellors
hetxura|hechura|hetxures|hechures=faiçó|forma|figura|factura
hortera=cursi|coent|ridícul|carrincló|de mal gust|ordinari|vulgar|kitsch
horterada=collonada|cursileria|vulgaritat
horterades=collonades|cursileries|vulgaritats
horteres=cursis|coents|ridículs|carrinclons|de mal gust|ordinaris|vulgars|kitsch
hostigament=fustigació
hostigar=fustigar|hostilitzar|escometre
huelga=vaga
huelgues=vagues
iglésia=església
iglésies=esglésies
imprimida=impresa
imprimides=impreses
imprimit=imprès|imprés
imprimits=impresos
inabarcable=inabastable|inassequible|que no es pot aconseguir
inabarcables=inabastables|inassequibles|que no es pot aconseguir
inalàmbric=sense fil|sense fils|sense cables
inalàmbrica=sense fil|sense fils|sense cables
inalàmbrics=sense fil|sense fils|sense cables
inalàmbriques=sense fil|sense fils|sense cables
inconfundible=inconfusible
inconfundibles=inconfusibles
inscribible=inscriptible
inscribibles=inscriptibles
jefatura=direcció|prefectura|comandament
jefatures=direccions|prefectures|comandaments
jefe=cap|capitost|director|capdavanter
jefes=caps|capitosts|directors|capdavanters
jeque=xeic
jeques=xeics
jerez=xerès|vi de xerès|Jerez
jerga=argot
jijonenca=xixonenca
le=la|li|les|l'he
ligon=seductor|pendó|triomfador|figura
ligona=seductora|pendó|triomfadora|figura
ligones=seductores|pendons|triomfadores|figures
ligons=seductors|pendons|triomfadors|figures
limpiaparabrises=eixugavidres|eixugaparabrisa|eixugaparabrises
lio=embolic|garbuix
lios=embolics|garbuixos
liosa=embolicaire|embolicadora|embrollaire|embulladora|embolicada|embullada
lioses=embolicaires|embolicadores|embrollaires|embulladores|embolicades|embullades
liosos=embolicaires|embolicadors|embrollaires|embulladors|embolicats|embullats
listín=guia telefònica
liós=embolicaire|embolicador|embrollaire|embullador|embolicat|embullat
llamatiu=cridaner|viu|llampant
llamatius=cridaners|vius|llampants
llamativa=cridanera|viva|llampant
llamatives=cridaneres|vives|llampants
lletrero=rètol
lletreros=rètols
llevadera=de bon portar|suportable
llevaderes=de bon portar|suportables
llevadero=de bon portar|suportable
llevaderos=de bon portar|suportables
llevadura=llevat|rent
llevadures=llevats|rents
lligon=seductor|pendó|triomfador|figura
lligona=seductora|pendó|triomfadora|figura
lligones=seductores|pendons|triomfadores|figures
lligons=seductors|pendons|triomfadors|figures
llimpiaparabrises=eixugavidres|eixugaparabrisa|eixugaparabrises
llistín=guia telefònica
loca=boja|folla|orada
loco=boig|foll|orat
locos=boigs|bojos|folls|orats
lograda=aconseguida|assolida|reeixida
logrades=aconseguides|assolides|reeixides
lograt=aconseguit|assolit|reeixit
lograts=aconseguits|assolits|reeixits
logro=aconseguiment|assoliment|obtenció|èxit|triomfs|encert|reeixida
logros=aconseguiments|assoliments|obtencions|èxits|triomfs|encerts|reeixides
loques=boges|folles|orades
làbia=facilitat de paraula|parola|vèrbola|verbositat
làmpara=llum|llàntia|làmpada
làmpares=llums|llànties|làmpades
línea=línia
línees=línies
malograda=malaguanyada
malogrades=malaguanyades
malograt=malaguanyat
malograts=malaguanyats
mamotreto=patracol|baluerna
mamotretos=patracols|baluernes
mamposteria=maçoneria
manantial=font|deu|brollador|mina|aiguaneix|aiguanaix
manantials=fonts|deus|brolladors|mines|aiguaneixos|aiguanaixos
mandamás|mandamàs=capità manaies|manaia
mando=comandament|quadre|control
mandona=manaire|autoritària|que vol manar-ho tot|manaia
mandones=manaires|autoritàries|que volen manar-ho tot|manaies
mandons=manaires|autoritaris|que volen manar-ho tot|manaies
mandon|mandón=manaire|autoritari|que vol manar-ho tot|manaia
mandos=comandaments|quadres|controls
mangant=pispa|tinyeta
mangants=pispes|tinyetes
mangonejar=manifassejar|maneflejar
manguera=mànega
mangueres=mànegues
manguito=maniguet|maneguí|manegot|abraçadora|anella
manguitos=maniguets|maneguins|manegots|abraçadores|anelles
manicurer=manicur
manicurera=manicura
manicureres=manicures
manicurers=manicurs
manida=suada|gastada|amanida
manides=suades|gastades|amanides
manit=suat|gastat
manits=suats|gastats
manivela=maneta
maniveles=manetes
mansana=illa|illa de cases
mansanes=illes|illes de cases
mantecado=mantegada|gelat de crema
mantecados=mantegades|gelats de crema
manteleria=joc de taula|tovalles i tovallons
manteleries=jocs de taula|tovalles i tovallons
mantel|mantels=tovalles|estovalles
mantequilla=mantega
mantequilles=mantegues
mantilla=mantellina
mantilles=mantellines
marabunta=desordre|destrucció|desgavell
marabuntes=desordres|destruccions|desgavells
maranya=embrolla|embolic|embull|brega
maranyes=embrolles|embolics|embulls|bregues
maremoto=sisme submarí|terratrèmol submarí
maremotos=sismes submarins|terratrèmols submarins
marica|maricon|maricó|mariquita=marieta|faldilletes|doneta|bardaix|homosexual
mariconada=mala jugada|mala passada|putada|porcada
mariconades=males jugades|males passades|putades|porcades
marimachos|marimatxos=gallimarsots|homenots
marimacho|marimatxo=gallimarsot|homenot
marimorena=brega|baralla|batussa|gresca|sarau|sagramental|escàndol|canyaret
mariques|maricons|mariquites=marietes|faldilletes|donetes|bardaixos|homosexuals
marmolista=marbrista
marmolistes=marbristes
marrano=marrà|porc
marranos=marrans|porcs
mascarilla=màscara|careta
mascarilles=màscares|caretes
matadero=escorxador|degollador|acorador
mataderos=escorxadors|degolladors|acoradors
matarife=matador|matancer|escorxador
matasanos=metjastre|medicastre
matasellos=matasegells|tampó
maton=buscabregues|pinxo|perdonavides|provocador
matons=buscabregues|pinxos|perdonavides|provocadors
matxembrada=encadellada|emmetxada
matxembrades=encadellades|emmetxades
matxembrat=encadellat|emmetxat
matxembrats=encadellats|emmetxats
mecatxis=caram|carat|renoi|manoi|bona l'hem feta|bo
medicions=mesuraments|mesuratges|mesures|amidaments
medició=mesurament|mesuratge|mesura|amidament
medievo=edat mitjana
medrar=surar|progressar|enfilar-se
mejillones=musclos|clòtxines
mejillon|mejillón=musclo|clòtxina
melenuda=peluda|cabelluda
melenudes=peludes|cabelludes
melenut=pelut|cabellut
melenuts=peluts|cabelluts
mema=tanoca|babaua|burra|inepta|totxa|talossa
membrets|membretes=capçaleres|encapçalaments
membret|membrete=capçalera|encapçalament
membrillo=codony|codonyer|codonyat|confitura de codony
membrillos=codonys|codonyers|codonyats|confitures de codony
memes=tanoques|babaues|burres|ineptes|totxes|talosses
memo=tanoca|babau|burro|inepte|totxo|talòs
memos=tanoques|babaus|burros|ineptes|totxos|talossos
mengua=minva
menguant=minvant
menguants=minvants
menoscabo=menyscapte
mensatge=missatge
mensatger=missatger
mensatgera=missatgera
mensatgeres=missatgeres
mensatgers=missatgers
mensatges=missatges
menudència=menudesa|petitesa
menudències=menudeses|petiteses
menyspreatiu=menyspreador
menyspreatius=menyspreadors
menyspreativa=menyspreadora
menyspreatives=menyspreadores
mercadillo=mercat ambulant|mercat|parades
mercadillos=mercats ambulants|mercats|parades
mercancia=mercaderia
mercancies=mercaderies
merci=gràcies|mercès
merendero=menjadors|berenadors
merendero=menjador|berenador
merluces=lluços
merluça=lluç
mesnada=mainada
mesnades=mainades
metxero=encenedor|bec de gas
metxeros=encenedors|becs de gas
mimbre=vímet|vim
mimbres=vímets|vims
mimos=moixaines|manyagues|festes
minusvalia=minusvalidesa
minusvalies=minusvalideses
mirilla=espiera|espiell
mirilles=espieres|espiells
mirona=badoca|tafanera|badaire
mirones=badoques|tafaneres|badaires
mirons=badocs|tafaners|badaires
miron|mirón=badoc|tafaner|badaire
mitgevals|migevals=medievals
mitgeval|migeval=medieval
moldejar=modelar|afaiçonar
moldura=motllura|motlura
moldures=motllures|motlures
molturació=mòlta|molinada
molturar=moldre|molinar
monsergues=històries|brocs|romançons|cançons
montacargues=muntacàrregues
montícul=monticle
montículs=monticles
monòcul=monocle
monòculs=monocles
moraleja=moralitat|moral
moralejes=moralitats|morals
mundo=bagul|cofre
mundos=baguls|cofres
munyequera=canellera
munyequeres=canelleres
murmull=murmuri|mormol|mormoleig
murmulls=murmuris|mormols|mormoleigs
màrmol=marbre
màrmols=marbres
màstils|mástils=pals|arbres|antenes|astes|mànecs
màstil|mástil=pal|arbre|antena|asta|mànec
máx=màx
naltros|nantros|nantres|mosatros|moatros|mosatres|nosatres|nosatros|nosaltros=nosaltres
nanay|nanai=creu-t'ho|ca|demà m'afaitaràs
navaja=navalla
navajes=navalles
navarra=navarresa|Navarra
navarres=navarreses
navarro=navarrès|Navarro
navarros=navarresos
navier=navilier
naviera=naviliera
navieres=navilieres
naviers=naviliers
naylon|nàylon|nailon|nàilon|nilon|nylon=niló
negrura=negror
neoyorkina|neoiorquina=novaiorquesa
neoyorkines|neoiorquines=novaiorqueses
neoyorkins|neoiorquins=novaiorquesos
neoyorkí|neoiorquí=novaiorquès|novaiorqués
newsletter=butlletí|butlletí d'informació|revista d'empresa
newsletters=butlletins|butlletins d'informació|revistes d'empresa
ninyera=mainadera|teta
ninyeres=mainaderes|tetes
nochebuena=nit de Nadal
nochevieja=nit de Cap d'Any
nombrament=nomenament
nombraments=nomenaments
novata=principiant|nova|novella|aprenenta|debutant|novençana|inexperta
novatada=quintada|novetat|mala jugada|innocentada|patenta
novatades=quintades|novetats|males jugades|innocentades|patentes
novates=principiants|noves|novelles|aprenentes|debutants|novençanes|inexpertes
novato=principiant|nou|novell|aprenent|debutant|novençà|passerell|inexpert|pipioli
novatos=principiants|nous|novells|aprenents|debutants|novençans|passerells|inexperts|pipiolis
novedosa=nova|innovadora
novedoses=noves|innovadores
novedosos=nous|innovadors
novedós=nou|innovador
novillada=correguda de jònecs
novillades=corregudes de jònecs
novillo=vedell|jònec|mec|bravell|bravatell
novillos=vedells|jònecs|mecs|bravells|bravatells
num=núm
numerosa=nombrosa
numeroses=nombroses
numerosos=nombrosos
numerós=nombrós
nurseria=sala de nadons|llar d'infants
nurseries=sales de nadons|llars d'infants
nutriment=nodriment
nàcar=nacre
nútria=llúdria|llúdriga
nútries=llúdries|llúdrigues
octavilla=full volant
octavilles=fulls volants
ofertar=fer una oferta|oferir
ojalà|ojalá=tant de bo|tant de bo que|així|avui fos i demà festa|Déu ho faci
ojo=compte|ull viu|alerta|ep|ei|cap viu|atenció
ola=ona|onada
ole=visca|bravo|molt bé
oleatge=onatge
oleatges=onatges
oles=ones|onades
olfat=olfacte
olvit=oblit
olvits=oblits
opresa=oprimida
opreses=oprimides
opresos=oprimits
oprès=oprimit
oprés=oprimit
opúscul=opuscle
opúsculs=opuscles
orfelinat=orfenat
orfelinats=orfenats
orilla=riba|vorera|ribera
orilles=ribes|voreres|riberes
oràcul=oracle
oràculs=oracles
otrosí=altressí|d'altra banda|altrament|petició secundària
pachucha|patxutxa=alacaiguda|esmaperduda|pioca|cloc-piu
pachuches|patxutxes=alacaigudes|esmaperdudes|pioques|cloc-piu
pachuchos|patxutxos=alacaiguts|esmaperduts|piocs|cloc-piu
pachucho|patxutxo=alacaigut|esmaperdut|pioc|cloc-piu
package=embalatge
packages=embalatges
pajarita=llacet|corbatí|corbata de llacet
pajarites=llacets|corbatins|corbates de llacet
palco=llotja
palcos=llotges
palillero|palilleros=portaescuradents
palillo|palillos=escuradents
palique|palica=xerrameca|vèrbola|xerrera|xarrera
palomita=roseta|crispeta
palomites=rosetes|crispetes
pamplines=ximpleses|nicieses|falòrnies|poca-soltades|bestieses|galindaines|camàndules
panader=forner|flequer
panaderia=forn|forn de pla|fleca
panaderies=forns|forns de pla|fleques
panaders=forners|flequers
pandilla=colla|trepa
pandilles=colles|trepes
pantano=pantà
pantorrilla=panxell|tou de la cama|ventre de la cama
pantorrilles=panxells|tous de les cames|ventres de les cames
panyal=bolquer|penyal
panyals=bolquers|penyals
paperes=galteres|parotiditis
papilla|papilles=farinetes|puré|pastetes|suspensió|pols|xixines|farina
paradògics|paradògiques=paradoxals
paradògic|paradògica=paradoxal
pararraios|pararrayos=parallamps
parisina=parisenca
parisines=parisenques
parisins=parisencs
parisí=parisenc
parladuries=enraonies
parpadeig=parpelleig
parque=parc
parques=parcs
parrafada=paràgraf llarg|tirallonga
parrafades=paràgrafs llargs|tirallongues
parranda=tabola|barrila|gresca|xala|borina
parrilla=graella
parrillada=graellada
parrillades=graellades
parrilles=graelles
parte=comunicat|informe
parxe=pegat
parxes=pegats
pasmosa=esbalaïdora
pasmoses=esbalaïdores
pasmosos=esbalaïdors
pasmós=esbalaïdor
patada=coça|puntada|puntada de peu|puntelló
patades=coces|puntades|puntades de peu|puntellons
patinasso=patinada
patinassos=patinades
pato=ànec
patos=ànecs
patosa=maldestra|graponera|desmanegada|carranca|talpera|inhàbil|feixuga|poc afortunada|amb poca gràcia
patoses=maldestres|graponeres|desmanegades|carranques|talperes|inhàbils|feixugues|poc afortunades|amb poca gràcia
patoso=maldestres|graponers|desmanegats|carrancs|talpers|inhàbils|feixucs|poc afortunats|amb poca gràcia
patranya=bola|faula|falòrnia|guatlla
patranyes=boles|faules|falòrnies|guatlles
patós=maldestre|graponer|desmanegat|carranc|talper|inhàbil|feixuc|poc afortunat|amb poca gràcia
peatonal=de vianants|per als vianants
peatonals=de vianants|per als vianants
peatons=vianants
peató=vianant
pegatina|enganxina=adhesiu
pegatines|enganxines=adhesius
peines|peinetes=pintes
peine|peineta=pinta
pelirroja=pèl-roja
pelirrojess=pèl-roges
pelirrojo=pèl-roig
pelirrojos=pèl-rojos
peluca=perruca
peluquer=perruquer|barber
peluquera=perruquera|barbera
peluqueres=perruqueres|barberes
peluqueria=perruqueria|barberia
peluqueries=perruqueries|barberies
peluquers=perruquers|barbers
penalti=penal
penaltis=penals
penalty=penal
penaltys=penals
pepino=cogombre
pepinos=cogombres
percance=contratemps
percances=contratemps
percanç=contratemps
pescadilla=llucet|llúcera
pescadilles=llucets|llúceres
pesquissa|pesquisa=perquisició|recerca|indagació
pesquisses|pesquises=perquisicions|recerques|indagacions
pestillo=pestell
pestillos=pestells
petxuga|pechuga=pit|pitrera
petxugues|pechugues=pits|pitreres
pinitos=primers passos|tempteigs
pitada=xiulada|cop de clàxon|colp de clàxon
pitades=xiulades|cops de clàxon|colps de clàxon
pitillera|pitilleres=portacigarrets|portacigarretes
pitillo=cigarret|cigarreta
pitillos=cigarrets|cigarretes
pitorro=broc|galet|piu
pitorros=brocs|galets|pius
planyidera=ploranera|ploramorts|ploracossos|ploraire
planyideres=ploraneres|ploramorts|ploracossos|ploraires
plaç=termini
plaços=terminis
plenar=omplir|emplenar
provist=proveït
provista=proveïda
provistes=proveïdes
provistos=proveïts
provists=proveïts
pàrpado=parpella
pàrpados=parpelles
pàrraf=paràgraf
pàrrafs=paràgrafs
párrocos|pàrrocos=rectors
párroco|pàrroco=rector
pèsams|pésams=condols|condolences
pèsam|pésam=condol|condolença
radera|radere|raere=darrere
reaci=refractari|reticent|renitent
reacis=refractaris|reticents|renitents
reapertura=reobertura
recader=ordinari|transportista
recaders=ordinaris|transportistes
recado=encàrrec|comanda|avís
recados=encàrrecs|comandes|avisos
red=xarxa
redada=batuda|pentinada
redades=batudes|pentinades
reds=xarxes
reflexar=reflectir
repost=recanvi
repostos=recanvis
reposts=recanvis
repuesto=recanvi
repuestos=recanvis
reàcia=refractària|reticent|renitent
reàcies=refractàries|reticents|renitents
sello=segell
sellos=segells
sequia=séquia|secada|sequedat
sequies=séquies|secades|sequedats
servilleta=tovalló
servilletes=tovallons
sombra=ombra|garjola|presó
sombres=ombres
sèquit=seguici
sèquits=seguicis
sèria=seriosa|sèrie
sèrio=seriós
sèrios=seriosos
tamany=mida|grandària|format|dimensió|proporció|volum
tamanys=mides|grandàries|formats|dimensions|proporcions|volums
texte=text|teste
textes=textos|texts|testes
toldo=vela|tendal|para-sol
toldos=veles|tendals|para-sols
tonta=ximple|beneita|bajana|babaua|tanoca|nècia|totxa|pallussa
tontada=beneiteria|ximpleria|bajanada|fotesa|beneitura|poca-soltada|niciesa|totxeria|bagatel·la|ximplesa|bajaneria|neciesa|ximplesa
tontades=beneiteries|ximpleries|bajanades|foteses|beneitures|poca-soltades|nicieses|totxeries|bagatel·les|ximpleses|bajaneries|necieses|ximpleses
tonteria=beneiteria|ximpleria|bajanada|fotesa|beneitura|poca-soltada|niciesa|totxeria|bagatel·la|ximplesa|bajaneria|neciesa|ximplesa
tonteries=beneiteries|ximpleries|bajanades|foteses|beneitures|poca-soltades|nicieses|totxeries|bagatel·les|ximpleses|bajaneries|necieses|ximpleses
tontes=ximples|beneites|bajanes|babaues|tanoques|nècies|totxes|pallusses
tonto=ximple|beneit|bajà|babau|tanoca|neci|totxo|pallús
tontos=ximples|beneits|bajans|babaus|tanoques|necis|totxos|pallussos
tumbona=gandula
tumbones=gandules
umbral=llindar
umbrals=llindars
urbano=urbà
vanguàrdia=avantguarda
vanguàrdies=avantguardes
variétés=varietats
vastedat=vastitud
vastedats=vastituds
xambelan=camarlenc
xambelans=camarlencs
xamusquina=socarrim|socarrat|cremat
xanflans=xamfrans
xanflà=xamfrà
xanxullos|chanchullos=tripijocs|martingales
xanxullo|chanchullo=tripijoc|martingala
xapussa=nyap|bunyol
xapusses=nyaps|bunyols
xarco=toll|bassal
xarcos=tolls|bassals
xarla=xerrada|xarrada|conferència
xarles=xerrades|xarrades|conferències
xatarra=ferralla|ferro vell|ferregada
xatarrero=ferroveller
xatarreros=ferrovellers
xatarres=ferralla|ferro vell|ferregada
xelins=xílings
xelí=xíling
xelín=xíling
xeripa=xamba|sort|casualitat
xifladura=guilladura|mania|ceba
xifladures=guilladures|manies|cebes
xillon=cridaner|viu|virolat|llampant
xillona=cridanera|viva|virolada|llampant
xillones=cridaneres|vives|virolades|llampants
xillons=cridaners|vius|virolats|llampants
xiripa=xamba|sort|casualitat
xispa=espurna|guspira|enginy|gràcia|agudesa|sal|jocositat
xispes=espurnes|guspires
xiste=acudit|facècia
xistes=acudits|facècies
xixanta=seixanta
xorra=idiota|ximple|estúpid|estúpida|poca-solta|inútil
xorrada=collonada|parida|bestiesa|animalada|poca-soltada|bajanada
xorrades=collonades|parides|bestieses|animalades|poca-soltades|bajanades
xorres=idiotes|ximples|estúpids|poca-soltes|inútils
xubasquero=impermeable
xubasqueros=impermeables
xunga=fotuda|cardada|complicada|peluda|magra|cascada|tarada|torrada|dura|conflictiva
xungo=fotuts|cardats|complicats|peluts|magres|cascats|tarats|torrats|durs|conflictius
xungo=fotut|cardat|complicat|pelut|magre|cascat|tarat|torrat|dur|conflictiu
xungues=fotudes|cardades|complicades|peludes|magres|cascades|tarades|torrades|dures|conflictives
xupet=xumet|xupló
xupetes|chupetes=xumets|xuplons
xupete|chupete=xumet|xupló
xupets=xumets|xuplons
xupitos|chupitos=didalets|gotets|colpets
xupito|chupito=didalet|gotet|colpet
xutxeria|chucheria=llaminadura|llepolia|gominola
xutxeries|chucheries=llaminadures|llepolies|gominoles
yate=iot
yates=iots
yunque=enclusa
yunques=encluses
zanja=rasa|vall|fossat
zanjes=rases|valls|fossats
